00102222
00102222
00102222
00144000
00044100
22000100
22200100
22200100