42114112430024344140
30003122104000230120
41314223023301241441
31020134312324442004
33440240312312440343
02144310213001244404
11003021300403244204
24043414342041413340
43233023033241430131
12102003143432232343
42321314431420434014
14430332412330400133
01413140123214202230
10301414433304031041
21042023400102031321
43044234330314410122
42301021300014224102
41013231102223113441
23243340303210032214
03020303134144123311
