14310431212434442343
10020203433324212032
22420000443440203300
02130103312211114212
00141312114202421000
32300000432020143313
41324233200310001434
41431444221004334004
11413013312143120042
40204221404424424102
20301430013312311344
40104304411330144012
03444244303134121333
12202043242201414320
31213144301201331302
40424120111313333320
30013333042241301124
40221122302404004243
00213404131344110431
40212400101312223303
