0423122104
3140002421
1310202104
3221224101
1433334212
0021030001
3043042130
1444411041
2321421424
0122420414
