31040114344111100322
43330103221021233322
14121003403232243012
11033201044341112003
32022324210112422334
12133314214420240013
11434302111204031103
24343112322323214420
33114233340323022034
23120432103423224400
23344433422113121400
22302322323031302444
30012040221402230430
12433021042430411043
10214234330120320140
33024320244040014404
11032143024412213044
02110210104321314142
14322230220031444132
33211031014004230103
