3424313441
1342442411
0114433313
2030011032
0420330202
4240142132
2021033102
2134230444
4422314442
0141144424
