2434414433131211212412223131133421333142243213423212114432342224141333131432421114421244334112332141
2423411342132441441413323142332212311442234213243244222121144114421134143342421213434231114234434441
3222441232434332424242312443213342312342314443323343333121223131211322222414123444444223434244412222
3122212122421223321411311441111413324241414423342312242234214231241224134243122114244141332113332123
3241331332413421143431113132421423424421423111142412423444334442121433211223343121142424313431243142
2421444314424313311231422312234331442123224423211234422414423311132443441123412341423231121311411121
4412212243444421111432121231114424134144234314131244222244444424332333312321244214321214233134142212
1243413233311423434434333122341122241432412222313312231224414431412442321344143444223411333112111244
3222212244223334141213222424233133214243442424342222441334213431321133413433222241213342433113233133
4444222234312414444414443244441112433324112223123322324223233321423422114432342333222212241422222331
1321211134113444222422421434323233333442344313421334113421232323141444442131241432222122313124431422
4312412122244232441424332334341343233432232323213432233113222133343441233422412434431144443212214211
2244434443233442313211233411112121143123442314414241211121144114242231423112334432313113424131221341
1243322242112221232113444243433332411122332221323123433142342113323344433113123143142241313314424232
4212233434434324233144321213224244221313432313344322224431142422314122441314232412424443244311411414
1221121312344343421124111232433221134334143112122314433331231114412321223334121341214221344221433134
4424341123312113311443331443423224114141312124134113344343444324441442324321222232221244222133421114
4212324124142112413421314141332133141141311444424112422143122123443444412324342132314412241144142121
2234114243434124232232442342242343421114234322242312421321314311314213113412324323121441222234331422
2422242443122242241113111232332121323424112313443131433223322413141142443141131231132214234212323431
3313323412334143432244412212211332444323123212241423344434242214221221342422343321111214223311211131
2413212123244132343132442234342243332121323413332112223223334341114234143414232432231312244432431323
2244234311234244434124324121143113111424122444341112442414114312224243424112341111233431143121213121
1143132322212331222421223231133442442211121442223431124321231124214333433124341431442232214213233143
4211233334343144114113313431241131124324322124143113314413213312421114144111121222113314214324211442
1421223144412112223214311443211413243124431123324144322344142234223141233233123442211334242144311241
4231314444313423134312123221244243131234422442343343242212424223112143323324143421124434241321444233
3322434324113311441414132342124313141133131242113343431423442133134311434323332112313311321213211122
4142141113434422232231411122232243212122344414214122432123432122333114114142332241423434444314134132
3222333424134434313112224333332221214222142124413141141332121323321211222113413141442442413323321132
1212344414414422331224123242341323224113434443111124434341141222344234234213313143413111124333132332
3311121342123143212132314134224122424213242441313421241114312132423213323122212222322332232231113431
3214433213322333243412143323213142134144333111332112221444423411443242441331213122322412223323431321
1134344222133414111341224142112123242312233421412214233343414144322211242322332321313313123323122114
2443223132422421324344444113413133211431412312131311143144341123344443122212133222422112223411431324
4312142244424142114224214341113334124414123112323423311342344122122133214221334443143334431422434122
2112112111444332242314421331442411131331424221432413313213211242233343322422334343211323233232343341
3442223131144132221232444142233413421123242334121322111121224431122342313232122412114131432434343344
3232133141421333244141134123323341431214243124221314144414133223231332423322423142321134242343232323
3314433233421334112323344231213111134313142232144212322112143142332132423434222212413142312321222431
3214131431324141121442131422334332144344212434414331122222124244131133212131321122132443131332144243
2243133312443213143424123434122243342441144232242332333333214424233133432411411243421443434144444141
4444221214324113224241312411142212414434413424213142112222311133414112234114233424242133213141234242
2312321343111311422132124312314341232234133442122324434242242323344122423312224211231411214231133132
3434131342312131222411421112342442213341221431134332244213433422323143411114334221244144413332334244
1444113222221334421422312331343443343141443114224433431134134111433344234124134213214331144222241341
1231243442342242422313413414112424214411443141123124322342214443422113232241244434121211324211324413
4132323444433123114321333421243232123112434333232144411234323112412441114241314341131432334243332411
2442221311222442433424443242224334321434244221412133124313314144141114131434143314222314231422333422
2231111214324444321414422244214434312311213321242242124213214314324233314244234443242143422234443232
4344222234232224442142121112223312322432124242122121442211233442413414333213213111132323444124324144
4242113414122442124413442243311112211432331232131211344222132134322111344423231344323141132342343133
3443243443322131133342422224223442211143144221144411333242221243242423322142142112413341213122141143
4423334123414141443333343121444442422131241311244142122323131331124122423313121134232243334332424423
3232214142114441423434311131312434312132112122114112113324213334324234242114221234224141144124222242
1341313244234332122214123144144113234424214441324321224244331223442411312114412234111211414213322143
1444341124331323142441234412422324212113312443442222433313411143232432141224143422223334231411433334
4314222214214323122133122243222434144212234442214343112341131314213441424142133432433114312131124113
1321222343211223342214424111344122223444322324114211431132244121431234311122233412412442134131343413
4223344423123133144323213134222442214411144223432312344332311144213311442111222233433314131113124131
2422123122114344113443442221223222141134134344324221443434424434221344412222243232312332434443213444
2222423232411222142223323432322233433333312242424334341332431123412414244114214142221233414212223114
1224224341424221313333322312342343443433123144344124432343414342141413342141442244213142421313243323
4123122431314122332422343243141412332422214123432322421123232343141143411233342212214214131122434433
4213342233414113421214244414122434221424234144443311434142232443241222432213224211442144213344433123
4443212123141321112233442132412344444234434224132234344221431432223411142141324242213434341311131124
1213213214143122412322241242341442213432424343114112414132131444231341224222444134431112444411231243
1312131431423314141321231134142214334344122134434422441431332142442132443333114134212313321323442221
3234331133131131341311443222224122223232132431424313213444123343212234311321321212123311331213243211
2213312142424424344231223324312111321123442212132134134322344121134321332221341211224224342334114423
1141314321224311124144233214241221134324311212432332111234133332234414324331312431142324312142332143
2333131143331232234344432114444424344323431232444223144421433332121123431241213444444212134213131443
2114442243213142334243131423234222223122311132132113322322142342312413322412432341422441422424122123
3421424243324231131324222443414433333322243232312234243441341244242334443321423334121132434221232334
1331413113334133312412234234331442332341211134324123142114324324433131312112322133432322432444233413
3222242313224111211341333142441441341324121144342334234322242132334441233342321241121424243332141131
3321111244444412343122331324331213344113132433234322331333432312341234311341344122244141413112111124
4134242443222421312224111423112124234241323442221144211111114443312123143421221342433214414122223331
1443234313213243414141333241442422232214131114323132311112443144141414233222421113113131131431234334
1243132231424344442431143124432212324124344332124341312112221343344223112123234321442112224441232344
4141124242334232231124421413111121332242122332221231241134242414132443334123241431324222414433224342
3433441124441211314314323413143111433331423214231344132121233131213212412312121124444443333414214421
3214214311323314233121241142244343432324133241111123314323433314142211422242423313231134131144242331
3242214431314412141114334141243412124414333234141324424332113331442214343141133342244442323112341242
1312344221314412444422332423114233414331341324412143214442213111413243133121314431231241144444423242
2314442212234314441232413211144333411443113343334413131422444144443421113332441443441111113322314111
1314434324233211222132132224412221123214224121221422442143333112243112443244243424132211423333434424
1443141221333412242344413434124114243312123341244134322422222113134334344241142114222111123244313143
1141441412413413321224412231241344111324142222314432222411413231122224311331333214221231212421111321
4423321421213434421441143423131311212232224111333211321232313112242223141233142444121234132214324143
3232144422131413113421232221332232321433343211113114144323313212313122311323421341212241441323234311
2133233424311341334124231133213413312111344323333321314212343441241213433111111441131313433322213333
1121242243114134434132112132213322133334232443334422213441342134123311313241144413111211132334323121
2214442323222113441414334122441221314243223122132224222233444122213421314123321241142422443214332234
3441141343131144232343434114131111422213331414412424411431321333334434332133412112234121421443222333
2232322212234322112211441223221313333314444431131433133223343343144231323212131112133112212221141423
3324231433413231342123411342413232413311323244244142141311142214112332421143444111433333124334433134
2333121334333421211342411222331212234214141222112344432242242343421423233231221312434241432243312324
3331442431343434124421134413111144321212432323313122433113134113121331231343133323414441323234232211
3324223413341214344334142431342424234341333234224122141234324222321144324234324313344231243123432312
