00442422340014401134
34401312241242311433
04201424211122112403
41444230432404344234
43133213401121011321
30021022404243014331
04044034301230302043
44331133030443301041
44022013441121311334
03330143201404011033
20324332204140311320
24232001421441202021
44440302434141432232
01413131012211322003
14224221043131421230
00234021132313201444
02214421140210003113
14013112113031021103
44024241142002122332
10100220332031000413
