42324202142421202403
22003133313014224012
40421431104223431403
40102301243113232114
42430402130303320114
43341022312041212113
03340000230233100242
22243100201442331200
34332343404032343301
41122110101332221031
00004220104030422302
00234144002111242212
03303031020340044300
43441134202040431320
00203022411141304010
01214110222011203021
21233222140424303204
12041233224121024134
24300211323341420013
13221423342141022440
