40312012423302444143
30213032400301400332
24020424243311013121
10133420300331433004
33342434311212344022
03002323403432430222
21431040443401434111
20212311333014403402
23321343423332120023
10203342003011303031
12402112110402422122
32113142003012230103
10020220400400100240
20414120031323211131
13101420311001214432
03334104212432404422
30304142301430101201
24000141202011310312
21233124424010120414
43411320102233121203
