00113411400023020101
30201203402221443230
02212323233203214233
41024042402101311023
10020121144402323313
21022122000210122311
41132022002132232241
00243411102233203421
21241112441110120200
24301000444341030024
43321413031101222342
23123200131441344204
21434023043142141020
31343343334302430312
11404100111433244020
30224331032443313144
34234311411124211304
14232130234433133301
22033133413430303331
41410033234440240304
