10001214333412413103
31143400114240431303
23101121014331431214
04011102333344241132
01201424002140114322
02231400223432211342
21342310422313142201
30144434134422021030
13322243312040201120
23032323042423414133
00230200100213443343
13443241344001022123
02034104040124243110
00204204010401430132
14003124241414343110
14220422401314041344
12210324301234443200
14424324444014200222
12332102344440131122
13142122123214113320
