33200143022021042111
10414213000241201444
13403243341310441421
32400100030440323144
30434102210331134201
41344004130141333330
43032340413431020404
04414120123012434011
44002001034134212402
00401240341312444044
00110330314214114340
32121414204143430111
40421302012324241334
13014132330424012011
00434003402340134101
30304213342304401204
23241032212332103313
30010124104424200133
14333240042411342401
04202141234131240333
