12031122021222233211
03432003422033442312
43004010401342041034
24324443334334231022
21120001004400421132
40023204240440141221
21241040131320301310
03120110231242012033
03314342104034333040
40233433241443412444
00143204431141030232
34033421341432333220
34024221001331340001
33000442044123133311
02210303322322223012
10433004230230111320
42114420413220110143
42003043313312114023
11241300223234403121
11131113403434301403
