10312010312223244322
04043403101144434143
42404231333113404144
32140021411413023243
11202411233322144023
04403132234312320331
10333104004122130034
13431331214032321134
44012014033322112143
20241331310304224311
10230023413441343232
24143321211324314403
43101443244403430132
24223431321104210101
14042330213214221132
01113421243121220212
02423402121313430122
01300212034243232010
40044301020002114343
13111442402303321320
