40410330404013301222
03402343320234222433
04424122303230121430
12113143312321410412
03043243412004011211
10344143010322304424
20322420141132132013
32201321340230342442
02402320430431040043
14124143412224024001
44410421222211322021
13422342421434040003
14400203241133102401
02110210211124201411
03103203021241240123
44040343033014342430
40334042432304201210
14131400004211112314
11044303023123442133
24104143242412333343
