34001301421224212104
42444304041421103221
20134434031112414322
24042211040123004033
01241304211234204301
10244141333403102112
24200232411222312132
30121403020234040231
11110104200401230343
41203340341320430122
33322344210412121302
24200440341030041110
01043033413212013000
32222121434321412104
24033242342012143333
42330334242040013340
40023023140240204440
34204214420430214001
00330423323110310221
23344214334110244102
