23334244320100222221
00332332033131402334
14222010001031100311
14312440231030234203
01222240131041213404
11322322210343304442
21404021112342323303
44102040024223023031
24042104014333432221
22033132342423034044
04323333124404223442
13340324233214034243
03331022220120123004
42431132403304022334
42412303212114023104
14113023213442142440
04110211310310033003
20220024204203430410
10313004300220014012
44312430222443301402
