03140021223002340411
23424212211000130440
13341001243321041412
20034002433003412143
23443440431132121224
20002202301021444124
31142032332023120340
22442011042220412242
44100123231303030013
01131203423003403010
41044002241130003313
11132104210111220130
02100134434211431002
02242310342133241130
43304302132334104312
40013104331020201014
42114222404234430224
03020404120300143441
20124321122001442001
44010001143134443002
