21030403322041343133
40134040324230203340
31102313200000013342
11140014000340121331
44110104314314201423
12010112203232424412
02034113102231131243
00244014101041044000
44402223422431431342
00240322003432442104
24034034202304243021
43004242202340133414
21441113031110413403
30114103133140440301
33144032220144134401
22211044134112232223
14024012331223124321
32231421420340023344
43413244210030403143
21100002112043310320
