21142014341304330141
33013132202111002331
00233143310024432402
30232313332024401334
32311044223314310414
24020104222032220343
41041024420013300020
03002240404231334042
42044322334223000420
11301233042230120404
41120221433042402400
40203203111230241410
32030303331231321400
20024313012043323230
41023042214141412021
31141040030023212401
41231024231431231434
11041011221313303221
13330333333123414411
11423242102010404120
