410101010101010101010
122212221222121212221
020202020202020202020
122212221222121212121
020202210202020202020
122212121212102012221
010101010101010101010